WTiat|What
WTiat|What
φλέγόμενο|φλεγόμενο
φλέγόμενου|φλεγόμενου
δηλητήριασαν|δηλητηρίασαν
εφόδιασαν|εφοδίασαν
κυκλώναν|κύκλωναν
συνοδέυσαν|συνόδευσαν
βουλίαζε|βούλιζε
επιτεθήκαν|επιτέθηκαν
φλέγόμενα|φλεγόμενα
άμαζες|άμαξες
κρατούντας|κρατώντας
crto|στο
δίκιό|δίκιο
Ιανουάριου|Ιανουαρίου
αήδιαζε|αηδίαζε
συνοδέυσε|συνόδευσε
Ακόυσα|Άκουσα
καλυτέρους|καλύτερους
ακουγεται|ακούγεται
σον|σου
ηου|που
πον|που
ενα|ένα
αυτους|αυτούς
απούσιαζε|απουσίαζε
Αίγυπτου|Αιγύπτου
Ακούσε|Άκουσε
Αλλη|Άλλη
Αλλον|Άλλον
Αλλωστε|Άλλωστε
Αναψε|Άναψε
Αντε|Άντε
Απειρος|Άπειρος
Απλωσε|Άπλωσε
Αρχοντες|Άρχοντες
Αw|Ανν
Κοροΐδευε|Κορόιδευε
Λκουσες|Άκουσες
Οχι|Όχι
Σκύφτηκαν|Σκέφτηκαν
Σκύφτηκε|Σκέφτηκε
Τδρωνε|Ίδρωνε
Τσως|Ίσως
άκουσει|ακούσει
ακουγοντας|ακούγοντας
ακουν|ακούν
ακούσε|άκουσε
αμυδρους|αμυδρούς
αναβλυζει|αναβλύζει
ανυπομονουν|ανυπομονούν
αποκαλουσαν|αποκαλούσαν
αποφυγει|αποφύγει
αρκουσε|αρκούσε
αρνουνται|αρνούνται
αυλικους|αυλικούς
αυλικου|αυλικού
αυτους|αυτούς
εντυπώσιαζαν|εντυπωσίαζαν
εντυπώσιασε|εντυπωσίασε
εξούσιαζε|εξουσίαζε
ζουμε|ζούμε
ζουσε|ζούσε
κοροΐδευε|κορόιδευε
ξεφυγει|ξεφύγει
πετυχαίνε|πετύχαινε
πολυτίμους|πολύτιμους
σκεφτουν|σκεφτούν
σκύφτηκαν|σκέφτηκαν
σκύφτηκε|σκέφτηκε
στρκρογυρνούσε|στριφογυρνούσε
συμβουλέυσαν|συμβούλευσαν
τραπέζιου|τραπεζιού
τψ|την
φλέγόμενη|φλεγόμενη
χαΐδεψε|χάιδεψε
Mta|Μια
mv|των
ot|οι
Tt|Τι
διπλάσιασε|διπλασίασε
εντυπώσιαζε|εντυπωσίαζε
ευώδιαζαν|ευωδίαζαν
κοροΐδευαν|κορόιδευαν
